###############################
#      bb b    *   *  * * *   #
# # # #b# # #*#*# # # #*#*#*# #
#   *     s**         *1  * * #
# # # # # #*# # #*#*# # # # #*#
#f 1          *  *  *         #
# # # # # # # # # #*# #*# # # #
#f  *     x*  *  1   *        #
# # # # #*# # # #*#*# # # # # #
#*    **  *       *    1      #
# #*# # # # # # #*# # # # # # #
#           *   *  *          #
###############################