###############################
#      ** *    *   *  * * *   #
# # # #*# # #*#*# # # #*#*#*# #
#   *     ***         *   * * #
# # # # # #*# # #*#*# # # # #*#
#             *  *  *         #
# # # # # # # # # #*# #*# # # #
#*  *     x*  *      *        #
# # # # #*# # # #*#*# # # # # #
#*    **  *       *           #
# #*# # # # # # #*# # # # # # #
#           *   *  *          #
###############################