###############################
#      b* *    *   *  * * *   #
# # # #*# # #*#*# # # #*#*#*# #
#   *     s**         *   * * #
# # # # # #*# # #*#*# # # # #*#
#f            *  *  *         #
# # # # # # # # # #*# #*# # # #
#*  *     x*  *      *        #
# # # # #*# # # #*#*# # # # # #
#*    **  *       *           #
# #*# # # # # # #*# # # # # # #
#           *   *  *          #
###############################