###############################
#      bb b    *   *  * * *   #
# # # #b# # #*#*# # # #*#*#*# #
#   *     s**         *   * * #
# # # # # #*# # #*#*# # # # #*#
#f            *  *  *         #
# # # # # # # # # #*# #*# # # #
#f  *     x*  *      *        #
# # # # #*# # # #*#*# # # # # #
#*    **  *       *           #
# #*# # # # # # #*# # # # # # #
#           *   *  *          #
###############################