###############################
#      bb b    *   *  * * *   #
# # # #b# # #*#*# # # #*#*#*# #
#   x     s**         *   * * #
# # # # # #*# # #*#*# # # # #*#
#f 1          *  *  *         #
# # # # # # # # # #*# #*# # # #
#f  *     x*  *      *        #
# # # # #*# # # #*#*# # # # # #
#*    **  *       *           #
# #*# # # # # # #*# # # # # # #
#           *   *  *          #
###############################